2
2
2 5 
15 15
0 x 0 0 0 0 0 b 0 0 0 0 0 x 0
x 0 0 0 0 0 0 0 0 0 0 0 0 0 x
0 0 0 0 0 0 0 0 0 0 0 0 0 0 0
0 0 0 0 - - - - - - 0 0 0 0 0
0 0 0 0 - - - - - - 0 0 0 0 0
0 0 0 0 0 0 0 0 0 0 0 0 0 0 0
0 0 0 0 0 0 2 1 0 0 0 0 0 0 0
i 0 0 0 0 0 1 2 0 0 0 0 0 0 i
0 0 0 0 0 0 0 0 0 0 0 0 0 0 0
0 0 0 0 - - - - - - 0 0 0 0 0
0 0 0 0 - - - - - - 0 0 0 0 0 
0 0 0 0 0 0 0 0 0 0 0 0 0 0 0
0 0 0 0 0 0 0 0 0 0 0 0 0 0 0
x 0 0 0 0 0 0 0 0 0 0 0 0 0 x
0 x 0 0 0 0 0 b 0 0 0 0 0 x 0
0 0 7 <-> 14 14 3
0 14 5 <-> 14 0 2