26 26
0  0  0  0  0  0  0  0  0  0  0  0  0  0  0  0  0  0  0  0  0  0  0  0  0  0
0  0  0  0  0  0  0  0  0  0  0  0  0  0  0  0  0  0  0  0  0  0  0  0  0  0
0  0  0  0  0  0  0  0  0  0  0  0  0  0  0  0  0  0  0  0  0  0  0  0  0  0
0  0  0  -  -  -  -  -  -  -  -  -  -  -  -  -  -  -  -  -  -  -  -  0  0  0
0  0  0  -  0  0  0  0  0  0  0  0  0  0  0  0  0  0  0  0  0  0  -  0  0  0
0  0  0  -  0  0  0  0  0  0  0  0  0  0  0  0  0  0  0  0  0  0  -  0  0  0
0  0  0  -  0  0  0  0  0  0  0  0  0  0  0  0  0  0  0  0  0  0  -  0  0  0
0  0  0  -  0  0  0  -  -  -  -  -  -  -  -  -  -  -  -  0  0  0  -  0  0  0
0  0  0  -  0  0  0  -  0  0  0  0  0  0  0  0  0  0  -  0  0  0  -  0  0  0
0  0  0  -  0  0  0  -  0  0  0  0  0  0  0  0  0  0  -  0  0  0  -  0  0  0
0  0  0  -  0  0  0  -  0  0  0  x  x  x  x  x  0  0  -  0  0  0  -  0  0  0
0  0  0  -  0  0  0  -  0  0  x  -  -  -  -  x  0  0  -  0  0  0  -  0  0  0
0  0  0  -  0  0  0  -  0  0  x  -  1  2  -  x  0  0  -  0  0  0  -  0  0  0
0  0  0  -  0  0  0  -  0  0  x  -  3  4  -  x  0  0  -  0  0  0  -  0  0  0
0  0  0  -  0  0  0  -  0  0  x  -  -  -  -  x  0  0  -  0  0  0  -  0  0  0
0  0  0  -  0  0  0  -  0  0  x  x  x  x  x  x  0  0  -  0  0  0  -  0  0  0
0  0  0  -  0  0  0  -  0  0  0  0  0  0  0  0  0  0  -  0  0  0  -  0  0  0
0  0  0  -  0  0  0  -  0  0  0  0  0  0  0  0  0  0  -  0  0  0  -  0  0  0
0  0  0  -  0  0  0  -  -  -  -  -  -  -  -  -  -  -  -  0  0  0  -  0  0  0
0  0  0  -  0  0  0  0  0  0  0  0  0  0  0  0  0  0  0  0  0  0  -  0  0  0
0  0  0  -  0  0  0  0  0  0  0  0  0  0  0  0  0  0  0  0  0  0  -  0  0  0
0  0  0  -  0  0  0  0  0  0  0  0  0  0  0  0  0  0  0  0  0  0  -  0  0  0
0  0  0  -  -  -  -  -  -  -  -  -  -  -  -  -  -  -  -  -  -  -  -  0  0  0
0  0  0  0  0  0  0  0  0  0  0  0  0  0  0  0  0  0  0  0  0  0  0  0  0  0
0  0  0  0  0  0  0  0  0  0  0  0  0  0  0  0  0  0  0  0  0  0  0  0  0  0
0  0  0  0  0  0  0  0  0  0  0  0  0  0  0  0  0  0  0  0  0  0  0  0  0  0
